5.ox
o..............o....
...o......ooo..oo...
.....o...o...oo.....
..oo..........o...o.
....oo........o...o.
