1111111111111
100100C0e00C1
1000011111001
10000e0e0e001
1P0011E000001
1111111111111